11111111111111
1110C101001001
1PC00000C01001
1E000000000001
11100100101011
11111111111111