11111111111111
11100101001001
1PC10000C01001
1E100000000001
10000100101011
11111111111111